FileCHK was written by Martin Kratz 
<martin.kratz@mail.telepac.pt>. This distribution
was compiled by Eric Phelps <http://www.ericphelps.com>.

FileCHK will check for files named FILE????.CHK in it's 
directory and rename those CHK files to the correct 
extension. FileCHK can identify the following file types:

3DS - 3D Studio
AI  - Adobe Illustrator
ASF - Microsoft Multimedia
AVI - Windows Movie
BMP - Windows Bitmap Image
CAB - Microsoft Cabinet
CDR - CorelDRAW
CHM - Compiled Help
DOC - Word Document
DWG - AutoCad Drawing
EXE - Executable Program
GIF - Compressed bitmap
HLP - Windows Help
HTM - Web Page
JPG - Compressed Picture
LNK - Windows Shortcut
MDB - Access Database
MID - MIDI Music
MOV - QuickTime Movie
MP3 - Compressed Music
MPG - Compressed Movie
PDF - Adobe Acrobat
PSD - Adobe Photoshop
PST - Outlook Personal Folder
QT  - QuickTime Movie
RAR - RAR Compressed Archive
RMI - MIDI Music
SWF - Macromedia Shockwave
TIF - Tagged Image Format
TTF - Font
TXT - Plain Text
URL - Internet Shortcut
WAV - Sound
XLS - Excel Spreadsheet
ZIP - PK Compressed Archive